1111111111111111111
111111111110C011111
1111111111100001111
1P000000000000000E1
1111111111100001111
111111111110C011111
1111111111111111111