111111111111111111111
1111111110C0111111111
111111111101111111111
111111111101111111111
101111111101111111101
1C00000000E00000000C1
101111111101111111101
111111111101111111111
111111111101111111111
1111111110P0111111111
111111111111111111111