111111111111111
1111111C1111111
111111101111111
111111101111111
1C00000E00000C1
111111101111111
111111101111111
1111111P1111111
111111111111111