11111111111111111111
100000010E0100000011
11100001000100001111
1C1100000000000011C1
10111001000100111001
100000010P0100000001
10000001000100000001
10000001111100000011
11000000010000000111
11100000010000001111
11111111111111111111