111111111111111111
111111111E11111111
11C0000010100000C1
111100001010000111
110000000000000001
100001100P00110001
111000111111100011
110000111111100001
1100000C111C000011
1C00111111111100C1
111111111111111111