11111111
1P00C001
100000E1
00000000