111111111111
1P000C0001E1
100000000111
1C000C000001
111111111111