1111111111
1P00000001
10000C0001
1110000001
1C100000E1
1111111111