111111111
1P000000111
1000C00E11111
10000000111111
111111111111111